1111111111111111111111111111111111111
110000000000000C00000C000000000000001
10100101001000001010010000000101C0C01
101001001010101000100100000C0C0C0C0C1
110000000C00C0000000000000C00000C0C01
10000000000000C00000C00000C00C0C0C0C1
101C00C0C0C00C00C00010100100000101001
1E0000000000000C0C0C0C0C0C0C0C0C0C001
11010010100100000101001000000C0C0C0C1
10100100101010100010010000000C00C0C01
110000000C00C000000000000CC00C0C0C0C1
10000000000000C00000C000000C0C00C0C01
1010010100100000101001000000C0C0C0C01
1010010010101010001001000000C00C0C0C1
1P0000000C00C0000000000000000CC00CCC1
1111111111111111111111111111111111111
